3 3 3 3 3 3 3 3 3 3 3 3 3 3 3 3 3 3 3 3 3 3 3 3 3 3 3 3 3 3
3 2 2 2 2 2 2 2 2 2 2 2 2 2 2 2 2 2 2 2 2 2 2 2 2 2 2 2 2 3
3 2 2 2 2 2 2 2 2 2 2 2 2 2 2 2 2 2 2 2 2 2 2 2 2 2 2 2 2 3
3 2 2 2 2 2 2 2 2 2 2 2 2 2 2 2 2 2 2 2 2 2 2 2 2 2 2 2 2 3
3 2 2 2 2 2 2 2 2 2 2 2 2 2 2 2 2 2 2 2 2 2 2 2 2 2 2 2 2 3
3 2 2 2 2 2 2 2 2 2 2 2 2 2 2 2 2 2 2 2 2 2 2 2 2 2 2 2 2 3
3 2 2 2 2 2 2 2 2 2 2 2 2 2 2 2 2 2 2 2 2 2 2 2 2 2 2 2 2 3
3 2 2 4 4 4 4 0 4 4 4 4 4 4 4 4 4 4 4 4 2 2 2 2 2 2 2 2 2 3
3 2 2 4 0 0 0 0 7 7 4 0 0 0 4 1 9 1 1 4 2 2 2 2 2 2 2 2 2 3
3 3 3 4 5 6 0 0 0 0 4 0 0 0 0 1 1 1 1 4 2 2 2 2 2 2 2 2 2 3
3 2 2 4 5 6 0 0 0 0 4 0 0 0 4 1 11 1 10 4 2 2 2 2 2 2 2 2 2 3
3 2 2 4 0 0 0 0 0 0 4 12 0 0 4 4 4 4 4 4 4 4 4 4 4 3 3 3 3 3
3 2 2 4 4 0 4 4 4 4 4 12 0 0 4 0 0 0 8 8 8 8 8 8 4 2 2 2 2 3
3 2 2 4 0 0 0 0 0 0 4 0 0 0 4 0 0 0 0 0 0 0 0 0 4 2 2 2 2 3
3 2 2 4 0 0 0 0 0 0 0 0 0 0 0 0 0 0 0 0 0 0 0 15 4 2 2 2 2 3
3 2 2 4 0 16 0 0 0 0 0 0 0 0 0 0 0 13 13 13 13 0 0 14 4 2 2 2 2 3
3 2 2 4 0 5 0 0 0 0 4 0 0 0 4 0 0 0 0 0 0 0 0 0 4 2 2 2 2 3
3 2 2 4 0 5 0 0 0 0 4 4 0 4 4 4 4 4 4 4 4 4 4 4 4 2 2 2 2 3
3 2 2 4 0 5 0 0 0 0 4 12 0 0 4 0 0 7 7 7 4 1 9 1 4 2 2 2 2 3
3 2 2 4 0 5 0 0 0 0 4 12 0 0 0 0 0 0 0 0 4 1 1 1 4 2 2 2 2 3
3 2 2 4 0 5 5 0 0 0 4 12 0 0 4 0 0 0 0 0 0 1 1 10 4 2 2 2 2 3
3 2 2 4 16 0 0 0 0 0 4 4 0 4 4 5 6 0 0 0 4 11 1 1 4 2 2 2 2 3
3 2 2 4 4 4 4 4 4 4 4 2 2 2 4 5 6 0 0 0 4 4 4 4 4 2 2 2 2 3
3 2 2 2 2 2 2 2 2 2 2 2 2 2 4 0 0 0 0 0 4 2 2 2 2 2 2 2 2 3
3 2 2 2 2 2 2 2 2 2 2 2 2 2 4 4 4 4 4 4 4 2 2 2 2 2 2 2 2 3
3 2 2 2 2 2 2 2 2 2 2 2 2 2 2 2 2 2 2 2 2 2 2 2 2 2 2 2 2 3
3 2 2 2 2 2 2 2 2 2 2 2 2 2 2 2 2 2 2 2 2 2 2 2 2 2 2 2 2 3
3 2 2 2 2 2 2 2 2 2 2 2 2 2 2 2 2 2 2 2 2 2 2 2 2 2 2 2 2 3
3 2 2 2 2 2 2 2 2 2 2 2 2 2 2 2 2 2 2 2 2 2 2 2 2 2 2 2 2 3
3 3 3 3 3 3 3 3 3 3 3 3 3 3 3 3 3 3 3 3 3 3 3 3 3 3 3 3 3 3